32 24
1  14 14 14 14 14 14 14 14 14 14 14 14 2  14 14 14 14 14 14 14 14 14 14 14 14 14 14 14 14 14 1
12 0  0  0  0  0  0  0  0  0  0  0  0  15 0  0  0  0  0  0  0  0  0  0  0  0  0  0  0  0  0  13
12 0  0  0  0  0  0  0  0  0  0  0  0  13 5  0  0  0  0  1  0  0  0  0  0  4  16 16 16 16 16 1
12 0  0  0  0  0  0  0  0  0  0  0  0  15 0  0  0  0  0  0  0  0  0  0  0  0  0  0  0  0  0  13
12 0  0  0  0  3  0  0  0  3  0  0  0  13 5  0  0  0  0  0  0  0  0  0  0  0  0  0  0  0  0  13
12 0  0  0  0  15 0  0  0  15 0  0  0  15 0  0  0  0  0  0  0  0  0  0  0  0  0  0  0  0  0  13
12 0  0  0  0  15 0  0  0  15 0  0  0  15 0  0  0  0  0  0  0  0  0  0  0  0  0  0  0  0  0  13
12 0  0  4  11 14 16 16 16 14 16 11 16 10 0  0  0  4  16 16 16 5  0  0  0  0  0  0  0  0  0  13
12 0  0  0  15 0  0  0  0  0  0  15 0  0  0  0  0  0  0  0  0  0  0  0  0  0  0  0  0  0  0  13
12 0  0  0  15 0  0  0  0  0  0  15 0  0  0  0  0  0  0  0  0  0  0  0  0  4  7  0  0  0  0  13
12 0  0  0  15 0  0  0  0  0  0  15 0  0  0  0  0  0  0  0  0  0  0  0  0  0  6  0  0  0  0  13
1  5  0  0  6  0  0  3  0  0  0  8  16 16 16 5  0  0  0  3  0  0  0  0  0  0  0  0  0  0  0  13
12 0  0  0  0  0  0  15 0  0  0  0  0  0  0  0  0  0  0  15 0  0  0  0  0  0  0  0  0  8  16 1
12 0  0  0  0  0  0  15 0  0  0  0  0  0  0  0  0  0  0  15 0  0  0  0  0  0  0  0  0  6  0  13
12 0  0  0  0  0  0  15 0  0  0  0  0  0  0  0  0  0  0  15 0  0  0  0  0  0  0  0  0  0  0  13
1  16 16 16 16 16 16 14 16 16 16 16 16 16 16 11 16 16 16 10 0  0  0  0  0  4  7  0  0  0  0  13
12 0  0  0  0  0  0  0  0  0  0  0  0  0  0  6  0  0  0  0  0  0  0  0  0  0  6  0  0  0  0  13
12 0  0  0  0  0  0  0  0  0  0  0  0  0  0  0  0  0  0  0  0  0  0  0  0  0  0  0  0  0  0  13
12 0  0  0  0  0  0  0  0  0  0  0  0  0  0  0  0  0  0  0  0  0  3  0  0  0  0  0  0  8  16 1
12 0  0  0  0  0  0  0  0  0  0  0  0  0  0  0  0  0  0  0  4  11 12 0  0  0  0  300  0  6  0  13
12 0  17 0  0  0  0  0  0  0  8  7  0  0  0  0  0  0  0  0  0  13 12 0  0  0  0  0  0  0  0  13
12 0  0  0  0  0  0  0  0  0  13 12 0  0  0  0  0  0  0  0  0  13 12 0  0  0  0  0  0  0  0  13
12 0  0  0  0  8  7  0  0  0  13 12 0  0  0  8  7  0  0  0  0  13 2  7  0  0  0  0  0  0  0  13
1  11 11 11 11 2  2  11 11 11 2  2  11 11 11 2  2  11 11 11 11 2  2  2  11 11 11 11 11 11 11 1