32 24
1  13 13 13 13 13 13 13 13 13 13 13 13 1  13 13 13 13 13 13 13 13 13 13 13 13 13 13 13 13 13 1
11 0  0  0  0  0  0  0  0  0  0  0  0  14 0  0  0  0  0  0  0  0  0  0  0  0  0  0  0  0  0  12
11 0  0  0  0  0  0  0  0  0  0  0  0  12 4  0  0  0  0  0  0  0  0  0  0  3  15 15 15 15 15 1
11 0  0  0  0  0  0  0  0  0  0  0  0  14 0  0  0  0  0  0  0  0  0  0  0  0  0  0  0  0  0  12
11 0  0  0  0  2  0  0  0  2  0  0  0  12 4  0  0  0  0  0  0  0  0  0  0  0  0  0  0  0  0  12
11 0  0  0  0  14 0  0  0  14 0  0  0  14 0  0  0  0  0  0  0  0  0  0  0  0  0  0  0  0  0  12
11 0  0  0  0  14 0  0  0  14 0  0  0  14 0  0  0  0  0  0  0  0  0  0  0  0  0  0  0  0  0  12
11 0  0  3  10 13 15 15 15 13 15 10 15 9  0  0  0  3  15 15 15 4  0  0  0  3  6  0  0  0  0  12
11 0  0  0  14 0  0  0  0  0  0  14 0  0  0  0  0  0  0  0  0  0  0  0  0  0  5  0  0  0  0  12
11 0  0  0  14 0  0  0  0  0  0  14 0  0  0  0  0  0  0  0  0  0  0  0  0  0  0  0  0  0  0  12
11 0  0  0  14 0  0  0  0  0  0  14 0  0  0  0  0  0  0  0  0  0  0  0  0  0  0  0  0  0  0  12
1  4  0  0  5  0  0  2  0  0  0  8  15 15 15 4  0  0  0  2  0  0  0  0  0  0  0  0  0  0  0  12
11 0  0  0  0  0  0  14 0  0  0  0  0  0  0  0  0  0  0  14 0  0  0  0  0  0  0  0  0  7  15 1
11 0  0  0  0  0  0  14 0  0  0  0  0  0  0  0  0  0  0  14 0  0  0  0  0  0  0  0  0  5  0  12
11 0  0  0  0  0  0  14 0  0  0  0  0  0  0  0  0  0  0  14 0  0  0  0  0  0  0  0  0  0  0  12
1  15 15 15 15 15 10 13 15 15 15 15 15 15 15 10 15 15 15 9  0  0  0  0  0  3  6  0  0  0  0  12
11 0  0  0  0  0  14 0  0  0  0  0  0  0  0  5  0  0  0  0  0  0  0  0  0  0  5  0  0  0  0  12
11 0  0  0  0  0  14 0  0  0  0  0  0  0  0  0  0  0  0  0  0  0  0  0  0  0  0  0  0  0  0  12
11 0  0  0  0  0  9  0  0  0  0  0  0  0  0  0  0  0  0  0  0  0  2  0  0  0  0  0  0  0  0  12
11 0  0  0  0  0  0  0  0  0  0  0  0  0  0  0  0  0  0  0  3  10 11 0  0  0  0  300  0  7  15 1
11 0  17 0  0  0  0  0  0  0  7  6  0  0  0  0  0  0  0  0  0  12 11 0  0  0  0  0  0  5  0  12
11 0  0  0  0  0  0  0  0  0  12 11 0  0  0  0  0  0  0  0  0  12 11 0  0  0  0  0  0  0  0  12
11 0  0  0  0  7  6  0  0  0  12 11 0  0  0  7  6  0  0  0  0  12 1  6  0  0  0  0  0  0  0  12
1  10 10 10 10 1  1  10 10 10 1  1  10 10 10 1  1  10 10 10 10 1  1  1  10 10 10 10 10 10 10 1