56 24
1  14 14 14 14 14 14 14 14 14 14 14 14 2  14 14 14 14 14 14 14 14 14 14 14 14 14 14 14 14 14 14 14 14 14 14 14 14 14 14 14 14 14 14 14 14 14 14 14 14 14 14 14 14 14 2 
12 0  0  0  0  0  0  0  0  0  0  0  0  15 0  0  0  0  0  0  0  0  0  0  0  0  0  0  0  0  0  13 0  0  0  0  0  0  0  0  0  0  0  0  0  0  0  0  0  0  0  0  0  0  0  13  
12 0  0  0  0  0  0  0  0  0  0  0  0  13 5  0  0  0  0  0  0  0  0  0  0  4  16 16 16 16 16 2  0  0  0  0  0  0  0  0  0  0  0  0  0  0  0  0  0  0  0  0  0  0  0  13
12 0  0  0  0  0  0  0  0  0  0  0  0  15 0  0  0  0  0  0  0  0  0  0  0  0  0  0  0  0  0  13 0  0  0  0  0  0  0  0  0  0  0  0  0  0  0  0  0  0  0  0  0  0  0  13
12 0  0  0  0  3  0  0  0  3  0  300  0  13 5  0  0  0  0  0  0  0  0  0  0  0  0  0  0  0  0  13 0  0  0  0  0  0  0  0  0  0  0  0  0  0  0  0  0  0  0  0  0  0  0  13
12 0  0  0  0  15 0  0  0  15 0  0  0  15 0  0  0  0  0  0  0  0  0  0  0  0  0  0  0  0  0  13 0  0  0  0  0  0  0  0  0  0  0  0  0  0  0  0  0  0  0  0  0  0  0  13
12 0  0  0  0  15 0  0  0  15 0  0  0  15 0  0  0  0  0  0  0  0  0  0  0  0  0  0  0  0  0  13 0  0  0  0  0  0  0  0  0  0  0  0  0  0  0  0  0  0  0  0  0  0  0  13
12 0  0  4  -11 14 16 16 16 14 16 11 1610  0  0  0  -4  -16 -16 -16 -3  0  0  0  0  0  0  0  0  0  13 0  0  0  0  0  0  0  0 0  0  0  0  0  0  0  0  0  0  0  0  0  0  0  13
12 0  0  0  15 0  0  0  0  0  0  15 0  0  0  0  0  0  0  0  0  0  0  0  0  0  0  0  0  0  0  0  0  0  0  0  0  0  0  0  0  0  0  0  0  0  0  0  0  0  0  0  0  0  0  13
12 0  0  0  15 0  0  0  0  0  0  15 0  0  0  0  0  0  0  0  0  0  0  0  0  4  7  0  0  0  0  0  0  0  0  0  0  0  0  0  0  0  0  0  0  0  0  0  0  0  0  0  0  0  0  13
12 0  0  0  15 0  0  0  0  0  0  15 0  0  0  0  0  0  0  0  0  0  0  0  0  0  6  0  0  0  0  0  0  0  0  0  0  0  0  0  0  0  0  0  0  0  0  0  0  0  0  0  0  0  0  13
1  5  0  0  6  0  0  0  0  0  0  9  16 16 16 5  0  0  0  3  0  0  0  0  0  0  0  0  0  0  0  0  0  0  0  0  0  0  0  0  0  0  0  0  0  0  0  0  0  0  0  0  0  0  0  13
12 0  0  0  0  0  0  3  0  0  0  0  0  0  0  0  0  0  0  15 0  0  0  0  0  0  0  0  0  8  5  0  0  0  0  0  0  0  0  0  0  0  0  0  0  0  0  0  0  0  0  0  0  0  0  13
12 0  0  0  0  0  0  15 0  0  0  0  0  0  0  0  0  0  0  15 0  0  0  0  0  0  0  0  0  6  0  0  0  0  0  0  0  0  0  0  0  0  0  0  0  0  0  0  0  0  0  0  0  0  0  13
12 0  0  0  0  0  0  15 0  0  0  0  0  0  0  0  0  0  0  15 0  0  0  0  0  0  0  0  0  0  0  0  0  0  0  0  0  0  0  0  0  0  0  0  0  0  0  0  0  0  0  0  0  0  0  13
1  16 16 16 16 16 16 14 16 16 16 16 16 16 16 11 16 16 1610  0  0  0  0  0  4  7  0  0  0  0  0  0  0  0  0  0  0  0  0  0  0  0  0  0  0  0  0  0  0  0  0  0  0  0  13
12 0  0  0  0  0  0  0  0  0  0  0  0  0  0  6  0  0  0  0  0  0  0  0  0  0  6  0  0  0  0  0  0  0  0  0  0  0  0  0  0  0  0  0  0  0  0  0  0  0  0  0  0  0  0  13
12 0  0  0  0  0  0  0  0  0  0  0  0  0  0  0  0  0  0  0  0  0  0  0  0  0  0  0  0  0  0  0  0  0  0  0  0  0  0  0  0  0  0  0  0  0  0  0  0  0  0  0  0  0  0  13
12 0  0  0  0  0  0  0  0  0  0  0  0  0  0  0  0  0  0  0  0  0  3  0  0  0  0  0  0  8  5  0  0  0  0  0  0  0  0  110  0  0  0  0  0  0  0  0  0  0  0  0  0  0  0  13
12 0  0  0  0  0  0  0  0  0  0  0  0  0  0  0  0  0  0  0  4  11 12 0  0  0  0  0  0  6  0  0  0  0  0  0  0  0  0  0  0  0  0  0  0  0  0  0  0  0  0  0  0  0  0  13
12 0  17 0  0  0  0  0  0  0  8  7  0  0  0  0  0  0  0  0  0  13 12 0  0  0  0  0  0  0  0  0  0  0  0  0  0  0  20 32 32 21  0  0  0  0  0  0  0  0  0  0  0  0  0  13
12 0  0  0  0  0  0  0  0  0  13 12 0  111  0  0  0  0  0  0  0  13 12 0   200  204  0  0  0  0  0  0  0  0  0  0  0  0  0  0  0  0  0  0  0  0  0  0  0  0  0  0  0  0  0  13
12 0  0  0  0  8  7  0  0  0  13 12 0  0  0  0  0  0  0  0  0  13 2  7  0  0  0  0  0  0  0  0  0  0  0  0  0  0  0  0  0  0  0  0  0  0  0  0  0  0  0  0  0  0  0  13
1  11 11 11 11 2  2  11 11 11 2  2  11 11 11 2  2  11 11 11 11 2  2  2  11 11 11 11 11 11 11 11 11 11 11 11 11 11 11 11 11 11 11 11 11 11 11 11 11 11 11 11 11 11 11 1
