300 10
10 1  1  1  1  1  1  1  1  1  1  1  1  1  1  1  1  1  1  1  1  1  1  1  1  1  1  1  1  1  1  1  1  1  1  1  1  1  1  1  1  1  1  1  1  1  1  1  1  1  1  1  1  1  1  1  1  1  1  1  1  1  1  1  1  1  1  1  1  1  1  1  1  1  1  1  1  1  1  1  1  1  1  1  1  1  1  1  1  1  1  1  1  1  1  1  1  1  1  1  1  1  1  1  1  1  1  1  1  1  1  1  1  1  1  1  1  1  1  1  1  1  1  1  1  1  1  1  1  1  1  1  1  1  1  1  1  1  1  1  1  1  1  1  1  1  1  1  1  1  1  1  1  1  1  1  1  1  1  1  1  1  1  1  1  1  1  1  1  1  1  1  1  1  1  1  1  1  1  1  1  1  1  1  1  1  1  1  1  1  1  1  1  1  1  1  1  1  1  1  1  1  1  1  1  1  1  1  1  1  1  1  1  1  1  1  1  1  1  1  1  1  1  1  1  1  1  1  1  1  1  1  1  1  1  1  1  1  1  1  1  1  1  1  1  1  1  1  1  1  1  1  1  1  1  1  1  1  1  1  1  1  1  1  1  1  1  1  1  1  1  1  1  1  1  1  1  1  1  1  1  1  1  1  1  1  1  1  1  1  1  1  1  1  1  1  1  1  1  9  
1  0  0  0  0  0  0  0  0  0  0  0  0  0  0  0  0  0  0  0  0  0  0  0  0  0  0  0  0  0  0  0  0  0  0  0  0  0  0  0  0  0  0  0  0  0  0  0  0  0 1  0  0  0  0  0  0  0  0  0  0  0  0  0  0  0  0  0  0  0  0  0  0  0  0  0  0  0  0  0  0  0  0  0  0  0  0  0  0  0  0  0  0  0  0  0  0  0  0  0  1  0  0  0  0  0  0  0  0  0  0  0  0  0  0  0  0  0  0  0  0  0  0  0  0  0  0  0  0  0  0  0  0  0  0  0  0  0  0  0  0  0  0  0  0  0  0  0  0  0  1  0  0  0  0  0  0  0  0  0  0  0  0  0  0  0  0  0  0  0  0  0  0  0  0  0  0  0  0  0  0  0  0  0  0  0  0  0  0  0  0  0  0  0  0  0  0  0  0  0  1  0  0  0  0  0  0  0  0  0  0  0  0  0  0  0  0  0  0  0  0  0  0  0  0  0  0  0  0  0  0  0  0  0  0  0  0  0  0  0  0  0  0  0  0  0  0  0  0  0 1  0  0  0  0  0  0  0  0  0  0  0  0  0  0  0  0  0  0  0  0  0  0  0  0  0  0  0  0  0  0  0  0  0  0  0  0  0  0  0  0  0  0  0  0  0  0  0  0  1
1 0  0  0  0  0  0  0  0  0  0  101 101 101 101 101 101 101 101 101 101 101 101 101 101 101 101 101 101 101 101 101 101 101 101 101 101 101 101 101 101 0 0 0 0 0 0 0 0 0 0 101 101 101 101 101 101 101 101 101 101 101 101 101 101 101 101 101 101 101 101 0 0 0 0 0 0 0 0 0 0 101 101 101 101 101 101 101 101 101 101 101 101 101 101 101 101 101 101 101 101 0 0 0 0 0 0 0 0 0 0 101 101 101 101 101 101 101 101 101 101 101 101 101 101 101 101 101 101 101 101 0 0 0 0 0 0 0 0 0 0 101 101 101 101 101 101 101 101 101 101 101 101 101 101 101 101 101 101 101 101 0 0 0 0 0 0 0 0 0 0 101 101 101 101 101 101 101 101 101 101 101 101 101 101 101 101 101 101 101 101 0 0 0 0 0 0 0 0 0 0 101 101 101 101 101 101 101 101 101 101 101 101 101 101 101 101 101 101 101 101 0 0 0 0 0 0 0 0 0 0 101 101 101 101 101 101 101 101 101 101 101 101 101 101 101 101 101 101 101 101 0 0 0 0 0 0 0 0 0 0 101 101 101 101 101 101 101 101 101 101 101 101 101 101 101 101 101 101 101 101 0 0 0 0 0 0 0 0 0 0 0 0 0 0 0 0 0 0 1
1 0  0  0  0  0  0  0  0  0  0  101 101 101 101 101 101 101 101 101 101 101 101 101 101 101 101 101 101 101 101 101 101 101 101 101 101 101 101 101 101 0 0 0 0 0 0 0 0 0 0 101 101 101 101 101 101 101 101 101 101 101 101 101 101 101 101 101 101 101 101 0 0 0 0 0 0 0 0 0 0 101 101 101 101 101 101 101 101 101 101 101 101 101 101 101 101 101 101 101 101 0 0 0 0 0 0 0 0 0 0 101 101 101 101 101 101 101 101 101 101 101 101 101 101 101 101 101 101 101 101 0 0 0 0 0 0 0 0 0 0 101 101 101 101 101 101 101 101 101 101 101 101 101 101 101 101 101 101 101 101 0 0 0 0 0 0 0 0 0 0 101 101 101 101 101 101 101 101 101 101 101 101 101 101 101 101 101 101 101 101 0 0 0 0 0 0 0 0 0 0 101 101 101 101 101 101 101 101 101 101 101 101 101 101 101 101 101 101 101 101 0 0 0 0 0 0 0 0 0 0 101 101 101 101 101 101 101 101 101 101 101 101 101 101 101 101 101 101 101 101 0 0 0 0 0 0 0 0 0 0 101 101 101 101 101 101 101 101 101 101 101 101 101 101 101 101 101 101 101 101 0 0 0 0 0 0 0 0 0 0 0 0 0 0 0 0 0 0 1  
1 0  0  0  0  0  0  0  0  0  0  101 101 101 101 101 101 101 101 101 101 101 101 101 101 101 101 101 101 101 101 101 101 101 101 101 101 101 101 101 101 0 0 0 0 0 0 0 0 0 0 101 101 101 101 101 101 101 101 101 101 101 101 101 101 101 101 101 101 101 101 0 0 0 0 0 0 0 0 0 0 101 101 101 101 101 101 101 101 101 101 101 101 101 101 101 101 101 101 101 101 0 0 0 0 0 0 0 0 0 0 101 101 101 101 101 101 101 101 101 101 101 101 101 101 101 101 101 101 101 101 0 0 0 0 0 0 0 0 0 0 101 101 101 101 101 101 101 101 101 101 101 101 101 101 101 101 101 101 101 101 0 0 0 0 0 0 0 0 0 0 101 101 101 101 101 101 101 101 101 101 101 101 101 101 101 101 101 101 101 101 0 0 0 0 0 0 0 0 0 0 101 101 101 101 101 101 101 101 101 101 101 101 101 101 101 101 101 101 101 101 0 0 0 0 0 0 0 0 0 0 101 101 101 101 101 101 101 101 101 101 101 101 101 101 101 101 101 101 101 101 0 0 0 0 0 0 0 0 0 0 101 101 101 101 101 101 101 101 101 101 101 101 101 101 101 101 101 101 101 101 0 0 0 0 0 0 0 0 0 0 0 0 0 0 0 0 0 0 1 
1 0  0  0  0  0  0  0  0  0  0  101 101 101 101 101 101 101 101 101 101 101 101 101 101 101 101 101 101 101 101 101 101 101 101 101 101 101 101 101 101 0 0 0 0 0 0 0 0 0 0 101 101 101 101 101 101 101 101 101 101 101 101 101 101 101 101 101 101 101 101 0 0 0 0 0 0 0 0 0 0 101 101 101 101 101 101 101 101 101 101 101 101 101 101 101 101 101 101 101 101 0 0 0 0 0 0 0 0 0 0 101 101 101 101 101 101 101 101 101 101 101 101 101 101 101 101 101 101 101 101 0 0 0 0 0 0 0 0 0 0 101 101 101 101 101 101 101 101 101 101 101 101 101 101 101 101 101 101 101 101 0 0 0 0 0 0 0 0 0 0 101 101 101 101 101 101 101 101 101 101 101 101 101 101 101 101 101 101 101 101 0 0 0 0 0 0 0 0 0 0 101 101 101 101 101 101 101 101 101 101 101 101 101 101 101 101 101 101 101 101 0 0 0 0 0 0 0 0 0 0 101 101 101 101 101 101 101 101 101 101 101 101 101 101 101 101 101 101 101 101 0 0 0 0 0 0 0 0 0 0 101 101 101 101 101 101 101 101 101 101 101 101 101 101 101 101 101 101 101 101 0 0 0 0 0 0 0 0 0 0 0 0 0 0 0 0 0 0 1
1 17 0  0   0  0  0  0  0  0  0  101 101 101 101 101 101 101 101 101 101 101 101 101 101 101 101 101 101 101 101 101 101 101 101 101 101 101 101 101 101 0 0 0 0 0 0 0 0 0 0 101 101 101 101 101 101 101 101 101 101 101 101 101 101 101 101 101 101 101 101 0 0 0 0 0 0 0 0 0 0 101 101 101 101 101 101 101 101 101 101 101 101 101 101 101 101 101 101 101 101 0 0 0 0 0 0 0 0 0 0 101 101 101 101 101 101 101 101 101 101 101 101 101 101 101 101 101 101 101 101 0 0 0 0 0 0 0 0 0 0 101 101 101 101 101 101 101 101 101 101 101 101 101 101 101 101 101 101 101 101 0 0 0 0 0 0 0 0 0 0 101 101 101 101 101 101 101 101 101 101 101 101 101 101 101 101 101 101 101 101 0 0 0 0 0 0 0 0 0 0 101 101 101 101 101 101 101 101 101 101 101 101 101 101 101 101 101 101 101 101 0 0 0 0 0 0 0 0 0 0 101 101 101 101 101 101 101 101 101 101 101 101 101 101 101 101 101 101 101 101 0 0 0 0 0 0 0 0 0 0 101 101 101 101 101 101 101 101 101 101 101 101 101 101 101 101 101 101 101 101 0 0 0 0 0 0 0 0 0 0 0 0 0 0 300 0 0  0  1  
1 0 0 0 0 0 0 0 0 0 0 100 0 100 0 100 0 100 0 100 0 100 0 100 0 100 0 100 0 100 0 0 0 0 0 0 0 0 0 0 0 100 0 100 0 100 0 100 0 100 0 100 0 100 0 100 0 100 0 100 0 0 0 0 0 0 0 0 0 0 0 100 0 100 0 100 0 100 0 100 0 100 0 100 0 100 0 100 0 100 0 0 0 0 0 0 0 0 0 0 0 100 0 100 0 100 0 100 0 100 0 100 0 100 0 100 0 100 0 100 0 0 0 0 0 0 0 0 0 0 0 100 0 100 0 100 0 100 0 100 0 100 0 100 0 100 0 100 0 100 0 0 0 0 0 0 0 0 0 0 0 100 0 100 0 100 0 100 0 100 0 100 0 100 0 100 0 100 0 100 0 0 0 0 0 0 0 0 0 0 0 100 0 100 0 100 0 100 0 100 0 100 0 100 0 100 0 100 0 100 0 0 0 0 0 0 0 0 0 0 0 100 0 100 0 100 0 100 0 100 0 100 0 100 0 100 0 100 0 100 0 0 0 0 0 0 0 0 0 0 0 0 0 0 0 0 0 0 0 0 0 100 0 100 0 100 0 100 0 100 0 100 0 100 0 100 0 100 0 0 0 0 0 0 0 0 0 0 0 0 0 0 0 0 0 0 0 0 0 1
1 0 0 205 203  205  205  0  0  0  0  0  0  0  0  0  0  0  0  0  0  0  0  0  0  0  0  0  0  0  0  0  0  0  0  0  0  0  0  0  0  0  0  0  0  0  0  0  0  0  0  0  0  0  0  0  0  0  0  0  0  0  0  0  0  0  0  0  0  0  0  0  0  0  0  0  0  0  0  0  0  0  0  0  0  0  0  0  0  0  0  0  0  0  0  0  0  0  0  0  0  0  0  0  0  0  0  0  0  0  0  0  0  0  0  0  0  0  0  0  0  0  0  0  0  0  0  0  0  0  0  0  0  0  0  0  0  0  0  0  0  0  0  0  0  0  0  0  0  0  0  0  0  0  0  0  0  0  0  0  0  0  0  0  0  0  0  0  0  0  0  0  0  0  0  0  0  0  0  0  0  0  0  0  0  0  0  0  0  0  0  0  0  0  0  0  0  0  0  0  0  0  0  0  0  0  0  0  0  0  0  0  0  0  0  0  0  0  0  0  0  0  0  0  0  0  0  0  0  0  0  0  0  0  0  0  0  0  0  0  0  0  0  0  0  0  0  0  0  0  0  0  0  0  0  0  0  0  0  0  0  0  0  0  0  0  0  0  0  0  0  0  0  0  0  0  0  0  0  0  0  0  0  0  0  0  0  0  0  0  0  0  0  0  0  0  0  0  0  1  
7  1  1  1  1  1  1  1  1  1  1  1  1  1  1  1  1  1  1  1  1  1  1  1  1  1  1  1  1  1  1  1  1  1  1  1  1  1  1  1  1  1  1  1  1  1  1  1  1  1  1  1  1  1  1  1  1  1  1  1  1  1  1  1  1  1  1  1  1  1  1  1  1  1  1  1  1  1  1  1  1  1  1  1  1  1  1  1  1  1  1  1  1  1  1  1  1  1  1  1  1  1  1  1  1  1  1  1  1  1  1  1  1  1  1  1  1  1  1  1  1  1  1  1  1  1  1  1  1  1  1  1  1  1  1  1  1  1  1  1  1  1  1  1  1  1  1  1  1  1  1  1  1  1  1  1  1  1  1  1  1  1  1  1  1  1  1  1  1  1  1  1  1  1  1  1  1  1  1  1  1  1  1  1  1  1  1  1  1  1  1  1  1  1  1  1  1  1  1  1  1  1  1  1  1  1  1  1  1  1  1  1  1  1  1  1  1  1  1  1  1  1  1  1  1  1  1  1  1  1  1  1  1  1  1  1  1  1  1  1  1  1  1  1  1  1  1  1  1  1  1  1  1  1  1  1  1  1  1  1  1  1  1  1  1  1  1  1  1  1  1  1  1  1  1  1  1  1  1  1  1  1  1  1  1  1  1  1  1  1  1  1  1  1  1  1  1  1  1  8  
