24 48
2  14 14 14 14 14 14 14 14 14 14 14 14 14 14 14 14 14 14 14 14 14 14 14 2
10 101 0 0  0  0  0  0  0  0  0  0  0  0  0  0  0  0  0  0  0  0  0  101 13
10 101 0 0  0  0  0  0  0  0  0  0  17 0  0  0  0  0  0  0  0  0  0  101 13
10 101 0 0  0  0  0  0  0  0  0  0  0  0  0  0  0  0  0  0  0  0  0  101 13
10 101 0 0  0  0  0  0  0  100 0 0  0  0  0  100 0 0  0  0  0  0  0  101 13
10 0   0 0  0  0  0  0  0  0  0  4  16 16 5  0  0  0  0  0  0  0  0  0  13
10 -1 -1 -1 -1 -1 -1 -1 -1 -1 -1 -1 -1 -1 -1 -1 -1 -1 -1 -1 -1 -1 -1 -1 13
10 -1 -1 -1 -1 -1 -1 -1 -1 -1 -1 -1 -1 -1 -1 -1 -1 -1 -1 -1 -1 -1 -1 -1 13
10 -1 -1 -1 -1 -1 -1 -1 -1 -1 -1 -1 -1 -1 -1 -1 -1 -1 -1 -1 -1 -1 -1 -1 13
10 -1 -1 -1 -1 -1 -1 -1 -1 -1 -1 -1 -1 -1 -1 -1 -1 -1 -1 -1 -1 -1 -1 -1 13
10 -1 -1 -1 -1 -1 -1 -1 -1 -1 -1 -1 -1 -1 -1 -1 -1 -1 -1 -1 -1 -1 -1 -1 13
10 0  101 0 0  0  0  0  0  0  0  0  0  0  0  0  0  0  0  0  0  101 0 0  13
10 0  101 0 0  0  0  0  0  0  0  0  0  0  0  0  0  0  0  0  0  101 0 0  13
10 0  101 0 0  0  0  0  0  0  0  0  0  0  0  0  0  0  0  0  0  101 0 0  13
10 0  101 0 0  0  0  0  0  0  0  0  0  0  0  0  0  0  0  0  0  101 0 0  13
13 -1 -1 -1 7  16 16 16 16 16 16 16 16 16 16 16 16 16 16 16 15 -1 -1 -1 13
10 200 200 200 15 0  0  0  0  0  0  0  0  0  0  0  0  0  0  0  0  0  0  0  13
10 200 201 200 15 0  0  0  0  0  0  0  0  0  0  0  0  0  0  0  0  0  0  0 13
10 200 200 200 15 0  0  0  0  0  0  0  0  0  0  0  0  0  0  0  0  0  0  0  13
2  16 16 16 10 0  0  0  0  0  0  0  0  0  0  0  0  0  0  0  0  16 16 16 2
10 0  0  0  0  0  0  0  0  0  0  0  100 0 0  100 0 0  100 0 0  100 0 0  13
10 0  0  0  0  0  0  0  0  3  0  0  0  0  0  0  0  0  0  0  0  0  0  0  13
10 101 101 101 101 101 101 101 13 16 16 16 16 16 16 16 16 16 16 16 16 16 16 2
10 101 101 101 101 101 101 101 15 0  0  0  0  0  0  0  0  0  0  0  0  0  0  13
10 101 101 101 101 101 101 101 15 0  0  0  0  0  0  0  0  0  0  0  0  0  0  13
10 0  0  0  0  0  200 200 200 13 0  0  0  0  0  0  0  0  0  0  0  0  0  0  13
10 0  0  0  0  0  200 200 200 13 200 200 200 200 200 200 200 200 200 200 200 200 200 200 13
10 0  0  0  4  16 16 16 16 10 200 200 200 200 200 200 200 200 200 200 200 200 200 200 13
10 0  0  0  0  0  0  0  0  0  0  0  0  0  0  0  0  0  0  0  0  101 0 0  13
10 0  0  0  0  0  0  0  0  0  0  0  0  0  0  0  0  0  0  0  0  101 0 0  13
10 0  0  0  0  0  0  0  0  0  0  0  0  0  0  0  0  0  0  0  0  101 0 0  13
10 0  0  0  0  0  0  0  0  0  0  0  0  0  0  0  0  0  0  0  0  101 0 0  13
10 0  0  0  0  0  0  0  0  0  0  0  0  0  0  0  0  0  0  0  0  101 0 0  13
2  16 16 16 16 16 16 16 16 16 16 16 16 16 16 16 16 16 16 16 5 -1 -1 -1  2
10 101 0 101 0 0  0  0  0  0  0  0  0  0  0  0  0  0  0  0  0  0  0  0  13
10 0 101 0 101 0  0  0  0  0  0  0  0  0  0  0  0  0  0  0  0  0  0  0  13
10 0 0   101 0 101 0 0  0  0  0  0  0  0  0  0  0  0  0  0  0  0  0  0  13
10 -1 -1 -1 -1 -1 -1 -1 -1 -1 -1 -1 -1 -1 -1 -1 -1 -1 -1 -1 -1 -1 -1 -1 13
10 -1 -1 -1 -1 -1 -1 -1 -1 -1 -1 -1 -1 -1 -1 -1 -1 -1 -1 -1 -1 -1 -1 -1 13
10 0  0  0  0  0  0  0  0  0  0  0  0  0  0  0  0  0  0  0  0  0  0  0  13
10 0  0  0  0  0  0  0  0  0  0  0  100 0 0  100 0 0  100 0 0  100 0 0  13
10 0  0  0  0  0  0  0  0  0  0  0  0  0  0  0  0  0  0  0  0  0  0  0  13
2  -1 -1 -1 4  16 16 16 16 16 16 16 16 16 16 16 16 16 16 16 16 16 16 16 2
10 101 0 101 0 0  0  0  0  0  0  0  0  0  0  0  0  0  0  0  0  0  0  0  13
10 101 0 101 0 0  0  0  0  0  0  0  0  0  0  0  0  0  0  0  0  0  300 0 13
10 101 0 101 0 0  0  0  0  0  0  0  100 0 0  100 0 0  100 0 0  100 0 0  13
10 101 0 101 0 0  0  0  0  0  0  0  0  0  0  0  0  0  0  0  0  0  0  0  13
2  11 11 11 11 11 11 11 11 11 11 11 11 11 11 11 11 11 11 11 11 11 11 11 2