56 24
2  14 14 14 14 14 14 14 14 14 14 14 14 14 14 14 14 14 14 14 14 14 14 14 14 14 14 14 14 14 14 14 14 14 14 14 14 14 14 14 14 14 14 14 14 14 14 14 14 14 14 14 14 14 14 2 
12 0  0  0  0  0  0  0  0  0  0  0  101  0  0  0  0  0  0  0  0  0  0  0  0  0  0  0  0  0  0  0  0  0  0  0  0  0  0  0  0  0  0  0  0  0  0  0  0  0  0  0  0  0  0  13  
12 0  0  0  0  0  0  0  0  0  0  0  0  0  0  0  0  0  0  0  0  0  0  0  0  0  0  0  0  0  0  0  0  0  0  0  0  0  0  0  0  0  0  0  0  0  0  0  0  0  0  0  0  0  0  13
12 0  17 0  0  0  0  0  0  0  0  0  0  0  0  0  0  0  0  0  0  0  0  0  0  0  0  0  0  0  0  0  0  0  0  0  0  0  0  0  0  0  0  0  0  0  0  0  0  0  0  0  0  0  0  13
12 0  0  0  0  0  0  0  0  0  0  0  0  0  0  0  0  0  0  0  0  0  0  0  0  0  0  0  0  0  0  0  0  0  0  0  0  0  0  0  0  0  0  0  0  0  0  0  0  0  0  0  0  300  0  13
12 0  0  0  0  0  0  0  0  0  0  0  0  0  0  0  0  0  0  0  0  0  0  0  0  200  0  200  0  0  0  0  0  0  0  0  0  0  0  0  0  0  0  0  0  0  0  0  0  0  0  0  0  0  0  13
2  11 11 11 7  0  0  0  0  0  0  0  0  0  0  0  0  0  0  0  0  0  0  0  0  0  0  0  0  0  0  0  0  0  0  0  0  0  0  0  0  0  0  0  0  0  0  0  0  0  0  0  0  0  0  13
2  2  2  2  12 0  21 0 14 33 0 14 22 0 14  0  0  0  0  0  0  0  0  0  0  0  0  0  0  0  8  11 11 11 7  0  0  0  0  0  0  0  0  0  0  0  0  0  0  0  0  0  0  0  0  0  0  4  11 11 11 2
2  2  2  2  12 0  0  0  0  0  0  0  0  0  0  0  0  0  0  0  0  0  0  0  13 2  2  2  12 0  0  0  0  0  0  0  0  0  0  0  0  0  0  0  0  0  0  0  0  0  0  0  9  2  2  2  
2  2  2  2  12 0  0  0  0  0  0  0  0  0  0  0  0  0  0  0  0  0  0  0  13 2  2  2  12 0  0  0  0  0  0  0  0  0  0  0  0  0  0  0  0  0  0  0  0  0  0  0  0  9  2  2
2  2  2  2  12 0  0  0  0  0  0  0  0  0  0  0  0  0  0  0  0  0  0  0  13 2  2  2  12 0  0  0  0  0  0  0  0  0  0  0  0  0  0  0  0  0  0  0  0  4  5  0  0  0  9  2
2  2  2  2  12 0  0  0  0  0  0  0  0  0  0  0  0  0  0  0  0  0  0  0  13 2  2  2  12 0  0  0  0  0  0  0  0  0  0  0  0  0  0  0  0  0  0  0  0  0  0  0  0  0  0  13
2  2  2  2  12 0  0  0  0  0  0  0  0  0  0  0  0  0  0  0  0  0  0  0  13 2  2  2  12 0  0  0  0  0  0  0  0  0  0  0  0  0  0  0  0  0  0  0  0  0  0  0  0  0  0  13
2  2  2  2  12 0  0  0  0  0  0  0  0  0  0  0  0  0  0  0  0  0  0  0  13 2  2  2  12 0  0  0  0  0  0  0  0  0  0  0  0  0  0  0  0  0  0  0  0  0  0  0  0  0  0  13
2  2  2  2  12 0  0  0  0  0  0  0  0  0  0  0  0  0  0  0  0  0  0  0  13 2  2  2  12 0  0  0  0  0  0  0  0  0  0  0  0  101  0  0  0  0  0  4  5  0  0  0  0  0  0  13
2  2  2  2  12 0  0  0  0  0  0  0  0  0  0  0  0  0  0  0  0  0  0  0  13 2  2  2  12 0  0  0  0  0  0  0  0  0  0  0  0  0  0  0  0  0  0  0  0  0  0  0  0  0  0  13
2  2  2  2  12 0  0  0  0  0  0  0  0  0  0  0  0  0  0  0  0  0  0  0  13 2  2  2  12 0  0  0  0  0  0  0  0  0  0  0  0  0  0  0  0  0  0  0  0  0  0  0  0  0  0  13
2  2  2  2  12 0  0  0  0  0  0  0  0  0  0  0  0  0  0  0  0  0  0  0  13 2  2  2  12 0  0  0  0  0  0  0  0  0  0  0  0  0  0  0  0  0  0  0  0  0  0  0  0  0  0  13
2  2  2  2  12 0  0  0  0  0  0  0  0  0  0  0  0  0  0  0  0  0  0  0  13 2  2  2  12 0  0  0  0  0  0  0  0  0  0  0  0  0  0  0  0  4  5  0  0  0  0  0  0  0  0  13
2  2  2  2  12 0  0  0  0  0  0  0  0  0  0  0  0  0  0  0  0  0  0  0  13 2  2  2  12 0  0  0  0  0  0  0  0  0  0  0  0  0  0  0  0  0  0  0  0  0  0  0  0  0  0  13
2  2  2  2  12 0  21 12 0 33 12 0 22 12 0  0  0  0  0  0  0  0  0  0  0  0  0  0  0  0  13 2  2  2  12 0  21 12 0 33 12 0 22 12 0  0  0  0  0  0  0  0  0  0  0  0  0  0  0  0  0  0  0  0  0  200  200  13
2  2  2  2  12 0  0  0  0  0  100  0  0  0  0  0  100  0  0  0  0  0  0  0  13 2  2  2  12 0  0  0  0  0  0  100  0  0  0  100  0  0  0  0  0  0  0  0  0  0  0  0  0  200  200  13
2  2  2  2  12 0  0  0  0  0  0  0  0  0  0  0  0  0  0  0  0  0  0  0  13 2  2  2  12 0  0  0  0  0  0  0  0  0  0  0  0  0  0  8  7  0  0  0  0  0  0  0  200  200  200  13
2  2  2  2  11 11 11 11 11 11 11 11 11 11 11 11 11 11 11 11 11 11 11 11 2  2  2  2  2  11 11 11 11 11 11 11 11 11 11 11 11 11 11 2  2  11 11 11 11 11 11 11 11 11 11 2

