25 72
2  14 14 14 14 14 14 14 14 14 14 14 14 14 14 14 14 14 14 14 14 14 14 14 14 2
10 0  0  0  0  0  0  0  0  0  0  0  0  0  0  0  0  0  0  0  0  0  0  0  0  13
10 0  0  0  0  0  0  0  0  0  0  0  0  0  0  0  0  0  0  0  0  0  0  0  0  13
10 0  0  0  0  0  0  0  0  0  0  0  0  0  0  0  0  0  0  0  0  0  0  0  0  13
10 0  17 0  0  200 0 0  0  0  0  0  0  0  0  0  0  0  0  0  0  0  0  0  0  13
10 0  0  0  0  200 200 0 0 0  200 0 0  0  0  200 0 0  0  0  0  0  0  0  0  13
10 0  0  0  0  0  200 200 0 0 0  0  0  0  0  0  0  0  0  0  3  0  0  0  0  13
2  16 16 16 16 5  0 200 200 0 0 1 0 0  0  0  1  0  0  0  0  15 0  0  0  0  13
10 0  0  0  0  0  0  200 200 0 0 0  0  0  0  0  0  0  0  0  15 0  0  0  0  13
10 0  0  0  0  0  0  0  200 200 0 0 0  0  0  0  0  0  0  0  15 0  0  0  0  13
10 0  0  0  0  0  0  0  200 200 0 0 0  0  0  0  0  0  0  0  15 0  0  0  0  13
10 0  0  0  0  0  0  0  200 200 0 0 0  0  0  0  0  0  0  0  15 19 5 0  0  0  19 -5 0  13
10 0  0  0  0  0  0  200 200 0 0 0  0  0  0  0  0  0  0  0  15 0  0  0  0  13
10 0  0  0  0  0  0  200 200 0 0 0  0  0  0  0  0  0  0  0  15 0  0  0  0  13
10 0  0  0  0  0  0  200 200 0 0 0  0  0  0  0  0  0  0  0  15 0  0  0  0  13
10 0  0  0  0  0  200 200 0 0 0  0  0  0  0  0  0  0  0  0  15 0  0  0  0  13
10 0  0  0  0  0  200 200 0 0 0  0  0  0  0  0  0  0  0  0  15 0  0  0  0  13
10 0  0  0  0  0  200 200 0 0 0  0  0  0  0  0  0  0  0  0  15 0  0  0  0  13
10 0  0  0  0  200 200 0 0 0  0  0  0  0  0  0  0  0  0  0  15 0  0  0  0  13
10 0  0  0  0  200 200 0 0 0  0  0  0  0  0  0  0  0  0  0  15 0  0  0  0  13
10 0  0  0  0  200 200 0 0 0  0  0  0  0  0  0  0  0  0  0  15 0  0  0  0  13
10 0  0  0  200 200 0 0 0  0  0  0  0  0  0  0  0  0  0  0  15 19 5 0  0  0  19 -5 0  13
10 0  0  0  200 200 0 0 0  0  0  0  0  0  0  0  0  0  0  0  15 0  0  0  0  13
10 0  0  0  200 200 0 0 0  0  0  0  0  0  0  0  0  0  0  0  15 0  0  0  0  13
10 0  0  0  0  200 200 0 0 0  0  0  0  0  0  0  0  0  0  0  15 0  0  0  0  13
10 0  0  0  0  200 200 0 0 0  0  0  0  0  0  0  0  0  0  0  15 0  0  0  0  13
10 0  0  0  0  200 200 0 0 0  0  0  0  0  0  0  0  0  0  0  15 0  0  0  0  13
10 0  0  0  0  0  200 0 0  0  0  0  0  0  0  0  0  0  0  0  15 0  0  0  0  13
10 0  0  0  0  0  200 0 0  0  0  0  0  0  0  0  0  0  0  0  15 0  0  0  0  13
10 0  0  0  0  0  200 0 0  0  0  0  0  0  0  0  0  0  0  0  15 0  0  0  0  13
10 0  0  0  0  0  0  200 0 0  0  0  0  0  0  0  0  0  0  0  15 0  0  0  0  13
10 0  0  0  0  0  0  200 0 0  0  0  0  0  0  0  0  0  0  0  15 19 5 0  0  0  19 -5 0  13
10 0  0  0  0  0  0  200 0 0  0  0  0  0  0  0  0  0  0  0  15 0  0  0  0  13
10 0  0  0  0  0  0  200 0 0  0  0  0  0  0  0  0  0  0  0  15 0  0  0  0  13
10 0  0  0  0  0  200 0 200 0 0  0  0  0  0  0  0  0  0  0  15 0  0  0  0  13
10 0  0  0  0  0  0  0  200 0 0  0  0  0  0  0  0  0  0  0  15 0  0  0  0  13
10 0  0  0  0  0  200 0 200 0 0  0  0  0  0  0  0  0  0  0  15 0  0  0  0  13
10 0  0  0  0  0  0  0  0  200 0 0  0  0  0  0  0  0  0  0  15 0  0  0  0  13
10 0  0  0  0  200 0 0  0  200 0 0  0  0  0  0  0  0  0  0  15 0  0  0  0  13
10 0  0  0  0  0  0  0  0  200 0 0  0  0  0  0  0  0  0  0  15 0  0  0  0  13
10 0  0  0  0  200 0 0  0  0  200 0 0  0  0  0  0  0  0  0  15 0  0  0  0  13
10 0  0  0  0  0  0  0  0  0  200 0 0  0  0  0  0  0  0  0  15 0  0  0  0  13
10 0  0  0  200 0 0  0  0  0  200 0 0  0  0  0  0  0  0  0  15 0  0  0  0  13
10 0  0  0  0  0  0  0  0  0  0  200 0 0  0  0  0  0  0  0  15 0  0  0  0  13
10 0  0  0  200 0 0  0  0  0  0  200 0 0  0  0  0  0  0  0  15 0  0  0  0  13
10 0  0  0  0  0  0  0  0  0  0  200 0 0  0  0  0  0  0  0  15 0  0  0  0  13
10 0  0  200 0 0  0  0  0  0  200 0 200 0 0  0  0  0  0  0  15 19 5 0  0  0  19 -5 0  13
10 0  0  0  0  0  0  0  0  0  0  0  200 0 0  0  0  0  0  0  15 0  0  0  0  13
10 0  0  200 0 0  0  0  0  0  200 0 200 0 0  0  0  0  0  0  15 0  0  0  0  13
10 0  0  0  0  0  0  0  0  0  0  0  0  200 0 0  0  0  0  0  15 0  0  0  0  13
10 0  200 0 0  0  0  0  0  200 0 0  0  200 0 0  0  0  0  0  15 0  0  0  0  13
10 0  0  0  0  0  0  0  0  0  0  0  0  200 0 0  0  0  0  0  15 0  0  0  0  13
10 0  200 0 0  0  0  0  0  200 0 0  0  200 0 0  0  0  0  0  15 0  0  0  0  13
10 0  0  0  0  0  0  0  0  0  0  0  0  0  200 0 0  0  0  0  15 0  0  0  0  13
10 200 0 0  0  0  0  0  0  200 0 0  0  0  200 0 0  0  0  0  15 0  0  0  0  13
10 0  0  0  0  0  0  0  0  0  0  0  0  0  200 0 0  0  0  0  15 0  0  0  0  13
10 200 0 0  0  0  0  0  200 0 0  0  0  0  200 0 0  0  0  0  15 19 5 0  0  0  19 -5 0  13
10 0  0  0  0  0  0  0  0  0  0  0  0  0  200 0 0  0  0  0  15 0  0  0  0  13
10 200 0 0  0  0  0  0  200 0 0  0  0  0  0  200 0 0  0  0  15 0  0  0  0  13
10 0  0  0  0  0  0  0  0  0  0  0  0  0  0  200 0 0  0  0  15 0  0  0  0  13
10 0  200 0 0  0  0  0  200 0 0  0  0  0  0  200 0 0  0  0  15 0  0  0  0  13
10 0  0  0  0  0  0  0  0  0  0  0  0  0  0  200 0 0  0  0  15 0  0  0  0  13
10 0  200 0 0  0  0  0  200 0 0  0  0  0  0  200 0 0  0  0  15 0  0  0  0  13
10 0  0  0  0  0  0  0  0  0  0  0  0  0  0  200 0 0  0  0  15 0  0  0  0  13
10 0  200 0 0  0  0  0  200 0 0  0  0  0  0  0  200 0 0  0  15 0  0  0  0  13
10 0  0  3  0  0  0  0  0  0  0  0  0  0  0  0  200 0 0  0  15 0  0  0  0  13
10 0  0  15 0  0  0  0  200 0 0  0  0  0  0  0  200 0 0  0  6  19 5 0  0  0  19 -5 0  13
10 0  0  15 0  0  0  0  0  0  0  0  0  0  0  0  200 0 0  0  0  0  0  0  0  13
10 300 0 15 0  0  0  0  0  0  0  0  0  0  0  0  200 0 0  0  0  0  0  0  0  13
10 0  0  15 0  0  200 0 200 0 200 0 200 0 200 0 200 0 0  200 200 0 0 0  0  13
10 0  0  15 0  0  0  0  0  0  0  0  0  0  0  0  0  0  0  0  0  0  0  0  0  13
2  11 11 2  11 11 11 11 11 11 11 11 11 11 11 11 11 11 11 11 11 11 11 11 11 2

19 -5 0