56 24
2  14 14 14 14 14 14 14 14 14 14 14 14 14 14 14 14 14 14 14 14 14 14 14 14 14 14 14 14 14 14 14 14 14 14 14 14 14 14 14 14 14 14 14 14 14 14 14 14 14 14 14 14 14 14 2 
12 0  0  0  0  0  0  0  0  0  0  0  0  0  0  0  0  0  0  0  0  0  0  0  0  0  0  0  0  0  0  0  0  0  0  0  0  0  0  0  0  0  0  0  0  0  0  0  0  0  0  0  0  0  0  13  
12 0  0  0  0  0  0  0  0  0  0  0  0  0  0  0  0  0  0  0  0  0  0  0  0  0  0  0  0  0  0  0  0  0  0  0  0  0  0  0  0  0  0  0  0  0  0  0  0  0  0  0  0  300 0  13
12 0  0  0  0  0  0  0  0  0  0  0  0  0  0  0  0  0  0  0  0  0  0  0  0  0  0  0  0  0  0  0  0  0  0  0  0  0  0  0  0  0  0  0  0  0  0  0  0  0  0  0  0  0  0  13
12 0  0  0  0  0  0  0  0  0  0  0  0  0  0  0  0  0  0  0  0  0  0  0  0  0  0  0  0  0  0  0  0  0  0  0  0  0  0  0  0  0  0  0  0  0  0  0  0  0  0  0  0  0  0  13
12 0  0  0  0  0  0  0  0  0  0  0  0  0  0  0  0  0  0  0  0  0  0  0  0 8 -16 -16 -16 -16 7 0 0  0  0  0  0  0  0  0  0  0  0  0  0  0  0  0  0  0  0  0  4  16 16 2
12 0  0  0  0  0  0  0  0  0  0  0  0  0  0  0  0  0  0  0  0  0  0  0 0 15 200 200 200 200 15 0 20 0 13 33 0 13 21 0 13  0  0  0  0  0  0  0  0  0  0  0  0  0  0  0  0  0  0  0  0  13
12 0  0  0  0  0  0  0  0  0  0  0  0  0  0  0  0  0  0  0  0  0  0  0 0 15 200 200 200 200 15 0 0 0  0  0  0  0  0  0  0  0  0  0  0  0  0  0  0  0  0  0  0  0  0  13
12 0  0  0  0  0  0  0  0  0  0  0  0  0  0  0  0  0  0  0  0  0  0  0 0 15 200 200 200 200 15 0 0 0  0  0  0  0  0  0  0  0  0  0  0  0  0  0  0  0  0  0  0  0  0  13
12 0  17 0  0  0  0  0  0  0  0  0  0  0  0  0  0  0  0  0  0  0  0  0 0 15 200 200 200 200 15 0 0 0  0  0  0  0  0  0  0  0  0  0  0  0  0  0  0  0  0  0  0  0  0  13
12 0  0  0  0  0  0  0  0  0  0  0  0  0  0  0  0  0  0  0  0  0  0  0  0  9  16 16 16 16 10 0  0  0  0  0  0  0  0  0  0  0  0  0  0  0  0  0  0  0  0  0  0  0  0  13
12 0  0  0  0  0  0  0  0  0  0  0  0  0  0  0  0  0  0  0  0  0  0  0  0  0  0  0  0  0  0  0  0  0  0  0  0  0  0  0  0  200 200 200 0 0 0 0  0  0  0  0  0  0  0  13
2  11 11 11 7  0  0  0  0  0  0  0  0  0  0  0  0  0  0  0  0  0  0  0  0  0  0  0  0  0  0  0  0  0  0  0  0  0  0  0  0  0  202 0 0  0  0  0  0  0  0  0  0  0  0  13
2  2  2  2  12 0  0  0  0  0  0  0  0  0  0  0  0  0  0  0  0  0  0  0  0  0  0  0  0  0  0  0  0  0  0  0  0  0  0  0  0  0  0  0  0  0  0  0  0  0  0  0  0  0  0  13
2  2  2  2  12 0  1  0  0  0  0  0  0  101 3  0 0  0  0  0  0  0  0  0  0  0  101 3  0 0  0  0  0  0  0  0  0  0  0  101 0  0 1  0  0  0  0  0  0  0  0  0  0  0  0  13
2  2  2  2  12 0  0  0  0  0  0  0  0  101 15 0 0  0  0  0  0  0  0  0  0  0  101 15 0 0  0  0  0  0  0  0  0  0  0  101 0  1 0  0  0  0  0  0  0  0  0  0  0  0  0  13
2  2  2  2  12 0  0  1  0  0  0  0  0  101 15 0 0  0  0  0  0  0  0  0  0  0  101 15 0 0  0  0  0  0  0  0  0  0  0  101 3  0 0  0  0  0  0  0  0  0  0  0  0  0  0  13
2  2  2  2  12 0  0  0  0  0  0  0  0  101 15 0 0  0  0  0  0  0  0  0  0  0  101 15 0 0  0  0  0  0  0  0  0  0  0  101 15 0 0  0  0  0  0  0  0  0  0  0  0  0  0  13
2  2  2  2  12 0  0  0  1  0  0  0  0  101 6  0 0  0  0  0  0  0  0  0  0  0  101 6  0 0  0  0  0  0  0  0  0  0  0  101 15 0 0  0  0  0  0  0  0  0  0  0  0  0  0  13
2  2  2  2  12 0  0  0  0  0  0  0  0  200 200 200 0 0 0 0  0  0  0  0  0  0  200 200 200 0 0 0 0  0  0  0  0  0  1  0  15 0  0  0  0  0  0  0  0  0  0  0  0  0  0  13
2  2  2  2  12 0  0  0  0  1  0  0  0  0  0  0  0  0  0  0  0  0  0  0  0  0  0  0  0  0  0  0  0  0  0  0  0  0  0  0  6  0  0  0  0  0  0  0  0  0  0  0  0  0  0  13
2  2  2  2  12 0  0  0  0  0  0  0  0  0  0  0  100 0 0  0  0  0  0  0  0  0  0  0  0  100 0 0  0  0  0  0  0  0  0  0  0  0  0  0  100 0 0  0  0  0  0  0  0  0  0  13
2  2  2  2  12 0  0  0  0  0  0  0  0  0  0  0  0  0  0  0  0  0  0  0  0  0  0  0  0  0  0  0  0  0  0  0  0  0  0  0  0  0  0  0  0  0  0  0  0  0  20 -16 0 21 -16 0  0  0  0  13
2  2  2  2  2  11 11 11 11 11 11 11 11 11 11 11 11 11 11 11 11 11 11 11 11 11 11 11 11 11 11 11 11 11 11 11 11 11 11 11 11 11 11 11 11 11 11 11 11 11 11 11 11 11 11 2